{
    "name": "level5",

    "timeLimit": 150,
    
    "mazeMap": [
        [0, 1, 0, 1, 1, 1, 0, 2, 0, 1, 0, 1, 0, 1, 1, 1, 1],
        [0, 0, 0, 0, 0, 1, 0, 1, 0, 1, 0, 1, 0, 1, 3, 1, 0],
        [1, 1, 1, 1, 0, 1, 5, 1, 0, 1, 0, 1, 0, 1, 0, 0, 0],
        [0, 0, 0, 0, 0, 1, 1, 1, 0, 1, 0, 1, 0, 0, 0, 1, 0],
        [1, 1, 0, 1, 0, 1, 0, 0, 0, 0, 0, 1, 0, 1, 1, 1, 0],
        [0, 1, 0, 1, 0, 1, 0, 1, 0, 1, 0, 1, 0, 1, 0, 0, 0],
        [0, 0, 0, 1, 0, 0, 0, 1, 0, 1, 0, 1, 0, 0, 0, 1, 1],
        [0, 1, 1, 1, 0, 1, 0, 1, 0, 1, 0, 1, 1, 1, 0, 1, 4],
        [0, 1, 4, 0, 0, 1, 0, 1, 1, 1, 0, 1, 0, 1, 0, 1, 0],
        [0, 1, 1, 1, 0, 1, 0, 1, 0, 1, 0, 1, 1, 1, 0, 0, 0],
        [0, 0, 0, 0, 0, 1, 0, 1, 0, 1, 0, 0, 0, 0, 0, 1, 1],
        [1, 0, 1, 1, 0, 1, 0, 1, 0, 1, 0, 1, 0, 1, 0, 1, 1],
        [0, 0, 0, 1, 0, 0, 0, 0, 0, 0, 0, 0, 0, 1, 0, 0, 0],
        [1, 1, 0, 1, 1, 1, 0, 1, 1, 0, 1, 1, 0, 1, 1, 1, 0],
        [1, 6, 0, 0, 0, 0, 0, 1, 0, 0, 1, 0, 0, 0, 0, 1, 0],
        [1, 1, 0, 1, 1, 1, 0, 0, 0, 1, 0, 0, 1, 1, 0, 0, 0],
        [0, 0, 0, 1, 0, 0, 0, 1, 0, 0, 0, 1, 1, 0, 0, 1, 1]
    ],

    "player": {
        "gridRefX": 8,
        "gridRefY": 9
    },

    "bot": {
        "speed": 30,
        "image": "",
        "bots": [
            {
                "gridRefX": 10,
                "gridRefY": 0
            },
            {
                "gridRefX": 4,
                "gridRefY": 6
            },
            {
                "gridRefX": 16,
                "gridRefY": 1
            },
            {
                "gridRefX": 0,
                "gridRefY": 16
            },
            {
                "gridRefX": 10,
                "gridRefY": 15
            }
        ]
    }
}