{
    "name": "level5",
    
    "mazeMap": [
        [0, 1, 0, 1, 0, 1, 0, 1, 0, 1, 0, 1, 0, 1, 0, 1, 0],
        [0, 1, 0, 1, 0, 1, 0, 1, 0, 1, 0, 1, 0, 1, 0, 1, 0],
        [0, 1, 0, 1, 0, 1, 0, 1, 0, 1, 0, 1, 0, 1, 0, 1, 0],
        [0, 1, 0, 1, 0, 1, 0, 1, 0, 1, 0, 1, 0, 1, 0, 1, 0],
        [0, 1, 0, 1, 0, 1, 0, 0, 0, 0, 0, 1, 0, 1, 0, 1, 0],
        [0, 1, 0, 1, 0, 1, 0, 1, 0, 1, 0, 1, 0, 1, 0, 1, 0],
        [0, 1, 0, 1, 0, 1, 0, 1, 0, 1, 0, 1, 0, 1, 0, 1, 0],
        [0, 1, 0, 1, 0, 1, 0, 1, 5, 1, 0, 1, 0, 1, 0, 1, 0],
        [0, 1, 0, 1, 0, 1, 0, 1, 1, 1, 0, 1, 0, 1, 0, 1, 0],
        [0, 1, 0, 1, 0, 1, 0, 1, 6, 1, 0, 1, 0, 1, 0, 0, 1],
        [0, 1, 0, 1, 0, 1, 0, 1, 0, 1, 0, 1, 0, 1, 0, 1, 1],
        [0, 1, 0, 1, 0, 1, 0, 1, 0, 1, 1, 1, 0, 1, 0, 1, 1],
        [0, 1, 0, 1, 0, 1, 0, 0, 0, 0, 0, 1, 0, 1, 0, 0, 0],
        [0, 1, 0, 1, 0, 1, 1, 1, 0, 1, 0, 1, 0, 1, 1, 0, 0],
        [0, 1, 0, 1, 0, 1, 0, 0, 0, 1, 0, 1, 0, 1, 0, 1, 0],
        [0, 1, 0, 1, 0, 1, 0, 1, 0, 1, 0, 1, 1, 1, 0, 1, 0],
        [0, 1, 0, 1, 0, 1, 0, 1, 0, 1, 0, 0, 0, 0, 0, 1, 0]
    ],

    "player": {
        "gridRefX": 10,
        "gridRefY": 3
    },

    "bot": {
        "speed": 30,
        "image": "",
        "bots": [
            {
                "gridRefX": 0,
                "gridRefY": 3
            },
            {
                "gridRefX": 2,
                "gridRefY": 3
            },
            {
                "gridRefX": 4,
                "gridRefY": 3
            },
            {
                "gridRefX": 6,
                "gridRefY": 3
            },
            {
                "gridRefX": 8,
                "gridRefY": 3
            }
        ]
    }
}