{
    "name": "level4",
    
    "mazeMap": [
        [0, 0, 0, 1, 1, 1, 0, 0, 0, 1, 0, 1, 1, 1],
        [0, 1, 0, 3, 0, 0, 0, 1, 6, 1, 0, 0, 0, 0],
        [0, 1, 1, 1, 1, 4, 0, 1, 0, 0, 0, 1, 1, 0],
        [0, 0, 0, 0, 0, 1, 0, 1, 1, 1, 0, 1, 0, 0],
        [1, 0, 1, 1, 0, 0, 0, 0, 0, 1, 1, 1, 0, 1],
        [1, 0, 0, 1, 1, 1, 0, 1, 0, 1, 0, 1, 0, 1],
        [1, 0, 0, 0, 0, 0, 0, 1, 0, 1, 0, 0, 0, 1],
        [0, 0, 1, 0, 1, 1, 0, 0, 0, 1, 0, 1, 0, 0],
        [0, 1, 1, 0, 0, 0, 0, 1, 0, 1, 0, 1, 1, 0],
        [0, 0, 0, 0, 1, 1, 1, 1, 0, 1, 0, 1, 0, 0],
        [1, 1, 1, 0, 0, 0, 1, 1, 0, 1, 0, 1, 1, 0],
        [1, 5, 1, 0, 1, 0, 0, 1, 0, 0, 0, 1, 0, 0],
        [1, 0, 2, 0, 1, 1, 0, 1, 0, 1, 0, 1, 0, 1],
        [1, 1, 1, 0, 0, 0, 0, 0, 0, 1, 0, 4, 0, 1]
    ],

    "player": {
        "gridRefX": 13,
        "gridRefY": 3
    },

    "bot": {
        "speed": 40,
        "image": "",
        "bots": [
            {
                "gridRefX": 12,
                "gridRefY": 11
            },
            {
                "gridRefX": 2,
                "gridRefY": 9
            },
            {
                "gridRefX": 0,
                "gridRefY": 2
            },
            {
                "gridRefX": 7,
                "gridRefY": 7
            }
        ]
    }
}